1111111111111111
100C001000C00001
1000001011111001
10111010100E1001
1000100010001001
1110100000000001
1000100111111001
1001100000000001
1000000000000001
1000000111111001
1111100100000001
1000100100000001
1000100100000001
1000000000001C01
1P00000010000001
1111111111111111
