111111111111
1P0001000001
100001011001
111101001101
100001101C01
1C1100001111
100100000001
1001000001C1
111111110001
100010000111
1E1000100001
111111111111
