111111111111111111
1100C0100001000001
110000101101000001
110110101101000001
100000000001000001
101111101111100011
10100C100000000001
101011101001111101
101000001001000001
101111011001000111
10000001E0P1000001
111101111111011001
1C0000000000000001
111111111111111111
