1111111111111111
1P010001C0011111
1001010111000111
1000010111010111
1001010111010111
1111010111010101
1000010111010101
1011110111010001
100C100011000101
1011100011111101
1000000000E00001
1111111111111111
