111111
1P0001
100001
110001
1C0001
100001
100001
100001
100011
100001
1000E1
111111
