1111111111111111
1111111111111111
1111111111111111
1111110000111111
1111100110011111
1110001001011111
111P001001011111
1110000110011111
1110000000111111
11111EC001111111
1111111111111111
1111111111111111
